100 лет Владивостоку пр-т, 40	КТЦ «Искра»		
100 лет Владивостоку пр-т, 42а	ТЦ «Искра», салон «МТС»		
100 лет Владивостоку пр-т, 68	ТЦ «Парус»	
2-я Шоссейная ул., 1	Дальневосточный банк		
5-я Проходная ул., 15	Магазин «Гиперавто»	
8-я ул., 35	ООО «Влад Мотор Инн корпорейшн»		
Алеутская ул., 11	ОАО «Приморгражданпроект»		
Березовая ул., 25	Проходная Владивостокского морского рыбного порта		
Бестужева ул., 31	Магазин «Сфера-Маркет»		
Борисенко ул., 27	Дальневосточный банк		
Борисенко ул., 35	Гипермаркет «РЕМИ»
Бородинская ул., 14	Гипермаркет «Три Кота»
Верхнепортовая ул., 27а	Дальневосточный банк		
Вилкова ул., 5	Гипермаркет «Реми»
Героев Тихоокеанцев ул., 5а	Гипермаркет «Три Кота»
Дальзаводская ул., 4	Торгово-технический центр «Дазел»	
Деревенская ул., 14	Гипермаркет «РЕМИ»
Калинина ул., 230	ТЦ «Диомид»		
Карла Жигура ул., 32	Дальневосточный банк
Кипарисовая ул., 18	Дальневосточный банк		
Красного Знамени пр-т, 57	Гипермаркет «РЕМИ»
Красного Знамени пр-т, 82	ТД «Тихоокеанский»		
Лермонтова ул., 85 (п. Трудовое)	Супермаркет «Надежда-95»
Луговая ул., 18	Торгово-пешеходный комплекс
Луговая ул., 91	ТЦ «Сфера Маркет»		
Маковского, 224	ООО «САММИТ МОТОРС (Владивосток)»
Набережная ул., 20	Гостиница «Экватор»		
Народный пр-т, 28	Супермаркет «Фреш 25»
Народный пр-т, 9, стр. 6	Аптека «АВС»		
Нейбута ул., 51	Магазин «Фреш 25»
Некрасовская ул., 29	Супермаркет «ОК!»	
Океанский пр-т, 17	БЦ «Фреш Плаза» (минимаркет «Парус»)
Океанский пр-т, 48а	Trinity Irish Pub		
Океанский пр-т, 48а	Дальневосточный банк
Павленко пер., 6	Супермаркет «Фреш 25»
Петра Великого ул., 2	Помещение «Фесконтракт Интернешионал»
Полетаева ул., 6д	ТРК «Седанка-Сити»
Посьетская ул., 20	Гостиница «Приморье»		
Пушкинская ул., 46	Дальневосточный банк
Русская ул., 19а	Дальневосточный банк		
Русская ул., 19а	Дальневосточный банк (со стороны ул. Кирова)		
Русская ул., 44	ТЦ «Универсам»
Русская ул., 94а	Магазин «Зеленый остров»
Русский остров, бухта Аякс	АЗК № 417		
Сахалинская ул., 48	Магазин «Ода»		
Светланская ул., 112	ТЦ «Стрелец»		
Светланская ул., 33	ГУМ	
Светланская ул., 72	Столовая ОАО «ДЦСС»
Семеновская ул., 15	Супермаркет «Фреш 25» (в ТЦ «Clover House»)		
Снеговая ул., 64	ОАО «Дальхимпром»		
Стрельникова ул., 9	Проходная Владивостокского морского торгового порта		
Тимирязева ул., 31	Супермаркет «Космос»		
Ульяновская ул., 7	Супермаркет «СуперГуд»		
Успенского ул., 58	Фабрика мороженого ООО «Владайс»		
Фонтанная ул., 40	ОАО «ДНИИМФ»
Черемуховая ул., 15	ТЦ «Черемушки»
Черняховского ул., 5	Супермаркет «Фреш 25»
Шилкинская ул., 10а	Супермаркет «РЕМИ»		
Юмашева ул., 19	Гипермаркет «Три Кота»